1111111111111111111111111111111111111111
1CCCCCCCCCCCCCCCCCCCCCCCCCCCCCCCCCCCCCC1
10C0C0C0C0C0C0C0C0C0C0C0C0C0C0C0C0C0C0C1
1C0C0C0C0C0C0C0C0C0C0C0C0C0C0C0C0C0C0C01
10C0C0C0C0C0C0C0C0C0C0C0C0C0C0C0C0C0C0C1
1C0C0C0C0C0C0C0C0C0C0C0C0C0C0C0C0C0C0C01
10C0C0C0C0C0C0C0C0C0C0C0C0C0C0C0C0C0C0C1
1C0C0C0C0C0C0C0C0C0C0C0C0C0C0C0C0C0C0C01
10C0C0C0C0C0C0C0C0C0C0C0C0C0C0C0C0C0C0C1
1C0C0C0C0C0C0C0C0C0C0C0C0C0C0C0C0C0C0C01
10C0C0C0C0C0C0C0C0C0C0C0C0C0C0C0C0C0C0C1
1C0C0C0C0C0C0C0C0C0C0C0C0C0C0C0C0C0C0C01
10C0C0C0C0C0C0C0C0P0C0C0C0C0C0C0C0C0C0C1
1C0C0C0C0C0C0C0C0C0C0C0C0C0C0C0C0C0C0C01
1C0C0C0C0C0C0C0C0C0C0C0C0C0C0C0C0C0C0C01
10C0C0C0C0C0C0C0C0C0C0C0C0C0C0C0C0C0C0C1
1C0C0C0C0C0C0CEC0C0C0C0C0C0C0C0C0C0C0C01
1C0C0C0C0C0C0C0C0C0C0C0C0C0C0C0C0C0C0C01
10C0C0C0C0C0C0C0C0C0C0C0C0C0C0C0C0C0C0C1
1C0C0C0C0C0C0C0C0C0C0C0C0C0C0C0C0C0C0C01
1CCCCCCCCCCCCCCCCCCCCCCCCCCCCCCCCCCCCCC1
1111111111111111111111111111111111111111