111111111111111
1000C0000C000C1
1000C0000C000C1
1000C0000C000C1
100000P00000C01
10000C000E0C001
1000C0000C000C1
1000C0000C000C1
111111111111111